CCTV-5	央视
CCTV-4(可回看)	央视
CCTV-1	央视
安徽卫视	卫视
CCTV-3	央视
CCTV-少儿	央视
CCTV-6	央视
CCTV-8	央视
CCTV5+高清(可回看)	央视
湖南卫视	卫视
浙江卫视	卫视
东方卫视	卫视
CCTV-5高清(可回看)	央视
CCTV-2(可回看)	央视
CCTV-10(可回看)	央视
CCTV-12	央视
CCTV-9纪录	央视
CCTV-7	央视
CCTV-11	央视
CCTV-1高清(可回看)	央视
江苏卫视	卫视
北京卫视	卫视
黑龙江卫视(可回看)	卫视
CCTV-音乐	央视
天津卫视	卫视
浙江高清(可回看)	卫视
江西卫视	卫视
CCTV-6高清(可回看)	央视
山东卫视(可回看)	卫视
CCTV-3高清(可回看)	央视
广东卫视	卫视
安徽高清(可回看)	卫视
东方高清(可回看)	卫视
湖南高清(可回看)	卫视
重庆卫视	卫视
辽宁卫视	卫视
江苏高清(可回看)	卫视
东南卫视(可回看)	卫视
深圳卫视	卫视
河南卫视	卫视
CCTV-8高清(可回看)	央视
河北卫视	卫视
陕西卫视	卫视
四川卫视	卫视
贵州卫视	卫视
湖北卫视	卫视
山西卫视	卫视
青海卫视	卫视
广西卫视	卫视
CCTV-9高清(可回看)	央视
云南卫视	卫视
北京高清(可回看)	卫视
内蒙古卫视	卫视
吉林卫视	卫视
黑龙江高清	卫视
天津高清(可回看)	卫视
宁夏卫视	卫视
甘肃卫视	卫视
中教一套	央视
广东高清(可回看)	卫视
深圳高清	卫视
湖北高清	卫视
电视指南	央视
新疆卫视	卫视
辽宁高清	卫视
四川高清	卫视
新疆兵团卫视	卫视
西藏卫视	卫视
CCTV-NEWS	央视
北京卫视(可回看)	卫视
凤凰卫视	卫视
北京高清	卫视
CCTV5+高清)可回看)	央视
CCTV-3(可回看)	央视
CCTV-9纪录(可回看)	央视
CCTV-8(可回看)	央视
湖南高清(可回￾)	卫视
CCTV-8高清	央视
CCTV-2	央视
旅游卫视	卫视
CCTV-3高清	央视
风云音乐	央视