CCTV-1	央视频道
CCTV-10	央视频道
CCTV-11	央视频道
CCTV-12	央视频道
CCTV-1高清	央视频道
CCTV-2	央视频道
CCTV-3	央视频道
CCTV-3高清	央视频道
CCTV-4	央视频道
CCTV-5	央视频道
CCTV-5高清	央视频道
CCTV-6	央视频道
CCTV-6高清	央视频道
CCTV-7	央视频道
CCTV-8	央视频道
CCTV-8高清	央视频道
CCTV-9纪录	央视频道
CCTV-9高清	央视频道
CCTV-NEWS	央视频道
CCTV-少儿	央视频道
CCTV-音乐	央视频道
CCTV5+高清	央视频道
东南卫视	卫视频道
东方卫视	卫视频道
东方高清	卫视频道
中教一套	央视频道
云南卫视	卫视频道
内蒙古卫视	卫视频道
凤凰卫视	卫视频道
北京卫视	卫视频道
北京高清	卫视频道
吉林卫视	卫视频道
四川卫视	卫视频道
四川高清	卫视频道
天津卫视	卫视频道
天津高清	卫视频道
宁夏卫视	卫视频道
安徽卫视	卫视频道
安徽高清	卫视频道
山东卫视	卫视频道
山西卫视	卫视频道
广东卫视	卫视频道
广东高清	卫视频道
广西卫视	卫视频道
新疆兵团卫视	卫视频道
新疆卫视	卫视频道
旅游卫视	卫视频道
江苏卫视	卫视频道
江苏高清	卫视频道
江西卫视	卫视频道
河北卫视	卫视频道
河南卫视	卫视频道
浙江卫视	卫视频道
浙江高清	卫视频道
深圳卫视	卫视频道
深圳高清	卫视频道
湖北卫视	卫视频道
湖北高清	卫视频道
湖南卫视	卫视频道
湖南高清	卫视频道
甘肃卫视	卫视频道
电视指南	央视频道
西藏卫视	卫视频道
贵州卫视	卫视频道
辽宁卫视	卫视频道
辽宁高清	卫视频道
重庆卫视	卫视频道
陕西卫视	卫视频道
青海卫视	卫视频道
风云音乐	央视频道
黑龙江卫视	卫视频道
黑龙江高清	卫视频道